++++++++++++++++++++++
+   +   ++ ++    +   +
      +     ++++++ + +
+ +    ++  ++++ ++ + +
+ +   + + ++    ++ + +
+          TT   ++ + +
+++++++ +  TT   ++ + +
+++++++++  + +  ++ + +
+          + +  ++ + +
+++++ + T+ + +     +S+
++++++++++++++++++++++