++++++++++++
+++      T++
++        ++
++ + +++   +
+++ +  ++  +
+++ +++ +  +
+          +
++++S++++  +
++++   ++  +
++ + + ++ ++
+ ++       +
+ ++ ++  + +
+ ++++   +  
+ +++  + +++
++      T+++
++++++++++++
