++++++++++++++++++++
+S  +          +++++
++  +       +       
+   ++++++  ++++++++
+  ++              +
+  T+++++++++++++  +
+                  +
++++++++++++++++++++